##########
#P  #    #
# ## # ## #
#    #    #
#### ###  #
#    #  E #
##########