###############
#P     #     E#
##### ### ### #
#     #     # #
# ### ##### ###
# #     #     #
# ####### #####
#             #
###############