##########
#P     E #
# ###### #
#        #
##########